AAAAAAAAAAAAAAAAAAAAAAAAAAAAAJMAAAMAAAMAAAMAAAAAAA
AAAAAAAAAAAAAAAAAAAAAAAAAAAAJ  _           AAAMAMA
AAAAAAAAAAAAAAAAAAAAAAAAAAAAM    c     a   MAAbb A
AAAAAAAAAAAAAAAAAAAAAAAAAAAAA              AAAb  M
AAAAAAAAAAAAAAAAAAAAAAAAAAAAA    DLD   c   AAA   A
AAAAAAAAAAAAAAAAAAAAAAAAAAAAA    LDL       JMJ   A
AAAAAAAAAAAAAAAAAAAAAAAAAAAAM    DLD  DLD        A
AAAAAAAAAAAAAAAAAAAAAAAAAAAAA         LDL   a    M
AAAAAAAAAAAAAAAAAAAAAAAAAAAAA    a    DLD        A
AAAAAAAAAAAAAAAAAAAAAAAAAAAAM              DLD   A
AAAAAAAAAAAAAAAAAAAAAAAAAAAAA        c     LDL   M
AAAAABBBBBBBAAAAAAAAAAAAAAAAAAMAA          DLD   A
AAAAAB  _  BBBBBBBBBBBBBBBBBBBBBM     a          A
AAAAAB     B                   BA           c    A
AAAAAB  c        c      c                        M
AAAAAB     B                   BAMAAAMAAAMAAAJ   A
AAAAAB     BBBBBBB BB BBBBBBBBBBBBBBAAAA         A
AAAAAB                             BAAAA    a    M
AAAAABBBB                          BAAAA         A
AAAAAAAABBBBBBBB  B  B  BBBBBBBBB  BAAAAAAAMA AMAA
AAAAAAAAAAAAAAAB  B  B  BBBBBBBBB  BAAAAAC       C
AAAAAAAAAAAAAAAB  B  B  BBBBBbb    BAAAAAC       C
AAAAAAAAAAAAAAAB  B  B  BBBBBb     BCCCCCC   C   C
AAAAAAAAAAAAAAAB  B  B  BBBBB                C   C
AAAAAAAAAAAAAAAB        BBBBB      BCCCCCC   C   C
AAAAAAAAAAAAAAAB        BBBBB   ^  BBBBCCC       C
AAAA      AAAAABBB BB BBBBBBBBBBBBBBBBBCCC   c   C
AAAA  c   AAAMAAJ      JAAMAAAAAAAAABBBCCC       C
AAA       M                  AAAAAAABBBCCC   C   C
AA        A   A          A   MCCCCCCCCCCCC   C   C
A>    c          c    c                      C   C
AA        A                                      C
AAA       M   A          A   MCCCCCCCCCCCCCCCCCCCC
AAAA  c   Abb               bAAAAAAAAAAAAAAAAAAAAA
AAAA      AAAMAAAMAAAMAAAMAAAAAAAAAAAAAAAAAAAAAAAA
AAAAAAAAAAAAAAAAAAAAAAAAAAAAAAAAAAAAAAAAAAAAAAAAAA